7 8 8 8 8 8 8 8 8 8 8 8 8 8 8 8 8 8 8 8 8 8 8 8 8 8 8 8 8 8 8 8 8 8 8 8 8 8 8 8 8 8 8 8 8 8 8 8 8 6
9 10 10 11 11 11 11 11 10 10 11 11 11 10 11 9 10 9 11 11 11 11 3 3 12 3 3 3 3 9 10 10 10 10 11 11 11 11 11 11 11 11 11 11 10 10 10 10 10 9
9 10 10 11 11 11 11 11 11 11 10 10 11 11 11 9 10 9 11 11 10 3 3 3 3 3 3 3 3 9 10 10 10 10 10 10 11 11 11 11 11 11 11 10 11 11 11 11 10 9
9 10 11 11 11 11 11 11 11 11 11 10 10 10 11 9 10 9 11 10 10 3 3 3 3 3 3 3 11 9 10 10 10 10 10 10 10 10 10 11 11 11 11 10 10 11 11 11 10 9
9 11 11 11 11 11 11 11 11 11 11 10 10 10 10 9 10 9 10 10 3 3 3 3 3 3 3 3 11 9 10 10 10 10 10 10 10 10 10 10 10 10 10 10 10 11 11 10 10 9
9 11 11 11 11 11 11 11 11 11 11 11 11 11 10 9 10 9 10 10 3 3 3 3 3 3 3 11 11 9 10 10 10 10 10 10 10 10 10 10 10 10 10 10 10 10 10 10 10 9
9 11 11 11 11 11 11 11 11 11 11 11 11 11 11 9 10 9 10 3 3 3 3 3 3 3 11 11 10 9 10 10 10 10 10 10 10 10 10 10 10 10 10 10 10 10 10 10 10 9
9 11 11 11 11 11 11 11 11 11 11 11 11 11 11 9 10 9 10 3 3 3 3 3 3 10 10 10 10 9 10 10 10 10 10 10 10 10 10 10 10 10 10 10 10 10 10 10 10 9
9 8 8 8 8 8 8 11 11 8 8 8 8 8 8 10 10 11 8 8 8 8 8 3 8 8 8 8 8 10 10 10 10 10 10 10 10 10 10 10 10 10 10 10 10 10 10 10 10 9
9 10 10 10 10 10 10 10 10 10 10 10 10 10 10 10 10 10 10 10 10 10 10 10 10 10 10 10 10 10 10 10 10 10 10 10 10 10 10 10 10 10 10 10 10 10 10 10 10 9
9 10 10 10 10 10 10 10 10 10 10 10 10 10 10 10 10 10 10 10 10 10 10 10 10 10 10 10 10 11 10 10 10 11 11 11 11 11 10 11 10 10 10 10 10 10 10 10 11 9
9 10 10 10 10 10 10 10 10 10 10 10 10 10 10 10 10 10 10 11 11 10 10 10 10 10 10 10 11 11 10 10 10 11 10 10 10 10 10 11 10 10 10 10 10 10 10 11 11 9
9 10 10 10 10 10 10 10 10 10 10 10 10 10 10 10 10 10 10 11 11 10 10 10 10 10 10 10 10 10 10 10 11 11 10 10 10 10 10 11 10 10 10 10 10 10 11 11 11 9
9 10 10 10 10 10 10 10 10 10 10 10 11 11 11 10 10 10 10 10 11 10 10 10 10 10 10 10 10 10 10 11 11 11 10 10 10 10 10 11 10 10 10 10 10 11 11 11 11 9
9 10 10 10 10 10 10 10 10 10 10 11 10 10 10 10 10 10 10 10 10 10 10 10 10 10 10 10 10 10 11 11 11 11 10 10 10 10 10 11 10 10 10 10 11 11 10 10 11 9
9 10 10 10 10 10 10 10 10 10 10 11 10 10 10 10 10 10 10 10 10 10 10 10 10 10 10 10 11 11 11 11 11 10 10 10 10 10 10 11 10 10 10 11 11 10 10 11 11 9
9 10 10 10 10 10 10 10 10 10 10 11 11 11 10 10 10 10 10 10 10 10 10 10 10 10 10 10 11 11 11 10 10 10 10 10 10 10 10 11 10 10 10 11 10 10 10 11 11 9
9 10 10 10 10 10 10 10 10 10 10 10 10 10 10 10 10 10 10 10 10 10 10 11 10 10 10 10 11 11 11 10 10 10 10 10 10 10 10 11 10 10 10 11 10 10 10 11 11 9
9 10 10 10 10 10 10 10 10 10 10 10 10 10 10 10 10 10 10 10 10 11 11 11 10 10 10 10 11 11 11 10 10 10 10 10 10 10 10 11 10 10 10 11 11 11 11 10 10 9
9 10 10 10 10 10 10 10 10 11 11 10 10 10 10 10 10 10 11 11 11 11 11 11 10 10 10 10 11 11 11 11 10 10 10 10 10 10 10 11 10 10 10 10 10 10 10 10 10 9
9 10 10 10 10 10 10 10 10 11 11 10 10 10 10 10 10 11 11 11 11 11 11 11 10 10 10 10 11 11 11 10 10 10 10 10 10 10 10 10 10 10 10 10 10 10 10 10 10 9
9 10 10 10 10 10 10 10 10 10 10 10 10 10 10 10 10 10 10 10 10 10 10 10 10 10 10 10 10 10 10 11 11 11 10 10 10 10 10 10 10 10 10 10 10 10 10 10 10 9
9 10 10 10 10 10 10 10 10 10 10 10 10 10 10 10 10 10 10 10 10 10 10 10 10 10 10 10 10 10 11 11 11 10 10 10 10 10 10 10 10 10 10 10 10 10 10 10 10 9
9 10 10 10 10 10 10 10 10 10 10 10 10 10 10 10 10 10 10 10 10 10 10 10 10 10 10 10 10 10 10 10 10 10 10 10 10 10 10 10 10 10 10 10 10 10 10 10 10 9
9 10 10 10 10 10 10 10 10 10 10 10 10 10 10 10 10 10 10 10 10 10 10 10 10 10 10 10 10 10 10 10 10 10 10 10 10 10 10 10 10 10 10 10 10 10 10 10 10 9
9 10 10 10 10 10 10 10 10 11 11 10 10 10 10 11 11 10 10 10 10 10 10 10 10 10 10 10 10 10 10 10 10 10 10 10 10 10 10 10 11 10 10 11 10 10 10 10 10 9
9 10 10 10 10 10 10 10 10 11 11 10 10 10 10 10 11 11 10 10 10 10 10 10 10 10 10 10 11 11 11 11 11 10 10 10 10 11 11 11 11 10 10 11 11 10 10 10 10 9
9 10 10 10 10 10 10 10 10 10 11 10 10 10 10 11 11 10 10 10 10 10 10 10 10 11 11 11 11 11 11 11 11 10 10 10 11 11 11 11 11 10 10 11 11 10 10 10 10 9
9 10 10 10 10 10 10 10 10 10 10 10 10 10 10 10 10 10 10 10 10 10 10 10 10 11 11 11 11 11 11 10 10 10 10 10 11 11 11 11 11 10 10 11 11 11 10 10 10 9
9 10 10 10 10 10 10 10 10 10 10 10 10 10 10 10 10 10 10 10 10 10 10 10 10 10 10 11 11 10 10 10 10 10 10 10 10 10 11 11 11 10 10 11 11 11 11 10 10 9
9 10 10 10 10 10 10 10 10 10 10 10 10 10 10 11 11 11 11 10 10 10 10 10 10 10 10 10 10 10 9 8 8 8 8 8 10 10 10 11 11 10 10 11 11 11 11 10 10 9
9 10 10 10 10 10 10 10 10 10 9 8 8 8 8 8 11 11 11 10 10 10 10 10 10 10 10 10 10 10 9 3 3 3 12 9 10 10 10 11 11 10 10 11 11 11 10 10 10 9
9 10 10 10 10 10 10 10 10 10 9 11 11 11 11 9 11 11 11 10 10 10 10 10 10 10 10 10 10 10 3 3 3 3 3 9 10 10 10 11 11 10 10 11 11 11 10 10 10 9
9 10 10 10 10 10 10 10 10 10 9 11 11 11 11 9 11 11 10 10 10 10 10 10 10 10 10 10 10 10 9 10 3 3 10 9 10 10 10 11 11 10 10 11 11 11 10 10 10 9
9 10 10 10 10 10 10 10 10 10 9 11 11 11 11 9 10 11 10 10 10 10 10 10 10 10 10 10 10 10 11 8 8 8 8 10 10 10 10 11 11 10 10 11 11 10 10 10 10 9
9 10 10 10 10 10 10 10 10 10 11 8 8 11 8 10 10 10 10 10 10 10 10 10 10 10 10 10 10 10 10 10 10 10 10 10 10 10 10 11 11 10 10 11 11 10 10 10 10 9
9 10 10 10 10 10 10 10 10 10 10 10 10 10 10 10 10 10 10 10 10 10 10 10 10 10 10 10 10 10 10 10 11 11 11 10 10 10 10 11 11 10 10 11 11 10 10 10 10 9
9 10 10 10 10 10 10 10 10 10 10 10 10 10 10 10 10 10 10 10 10 10 10 10 10 10 10 10 10 11 11 11 11 11 11 11 11 11 11 11 11 10 10 11 11 10 10 10 10 9
9 10 10 10 10 10 10 10 10 10 10 10 10 10 10 10 10 10 10 10 10 10 10 10 10 10 10 10 10 11 11 11 11 11 11 11 11 11 11 11 11 10 10 11 11 10 10 10 10 9
9 10 10 10 10 10 10 10 10 10 10 10 10 10 10 10 10 10 10 10 10 10 10 10 10 10 10 11 11 11 11 11 11 11 11 11 11 11 11 11 11 10 10 11 11 10 10 10 10 9
9 10 10 10 10 10 10 10 10 10 10 10 10 10 10 10 10 10 10 10 10 10 10 10 10 10 10 10 10 10 10 10 10 10 10 10 10 10 10 10 10 10 10 11 10 10 10 10 10 9
9 10 10 10 11 11 10 10 10 10 10 10 10 11 11 10 10 10 10 10 10 10 10 10 10 10 10 10 10 10 10 10 10 10 10 10 10 10 10 10 10 10 10 11 11 10 10 10 10 9
9 10 10 10 11 11 10 10 10 10 10 10 11 11 11 11 10 10 10 10 10 10 10 10 10 10 10 10 10 10 10 10 10 10 10 10 10 10 10 10 10 10 10 11 11 11 10 10 10 9
9 10 10 11 11 11 11 10 10 10 10 10 11 11 11 10 10 10 10 11 10 10 10 10 10 10 10 10 10 10 10 10 10 10 10 10 10 10 10 10 10 10 10 10 11 11 11 10 10 9
9 10 10 11 11 11 11 10 10 10 10 10 10 10 11 10 11 10 10 11 11 11 11 11 11 11 10 10 10 10 11 11 11 11 11 11 11 10 10 10 10 10 10 10 11 11 11 10 10 9
9 10 10 11 11 11 11 10 10 10 10 10 10 10 10 10 10 10 10 10 11 11 11 11 11 11 10 10 10 10 11 11 11 11 11 10 10 10 10 10 10 10 11 11 11 11 11 10 10 9
9 10 10 11 11 11 11 10 10 10 10 10 10 10 10 10 10 10 10 10 10 11 11 11 11 11 10 10 10 10 11 11 11 11 10 10 10 10 10 10 10 10 11 11 11 11 10 10 10 9
9 10 10 10 11 11 10 10 10 10 10 10 10 10 10 10 10 10 10 10 10 10 11 11 10 10 10 10 10 10 11 10 10 10 10 10 10 10 10 10 10 10 10 10 10 10 10 10 10 9
9 10 10 10 10 10 10 10 10 10 10 10 10 10 10 10 10 10 10 10 10 10 10 10 10 10 10 10 10 10 10 10 10 10 10 10 10 10 10 10 10 10 10 10 10 10 10 10 10 9
5 8 8 8 8 8 8 8 8 8 8 8 8 8 8 8 8 8 8 8 8 8 8 8 8 8 8 8 8 8 8 8 8 8 8 8 8 8 8 8 8 8 8 8 8 8 8 8 8 4
